//MAP CONVERTED BY dmm2tgm.py THIS HEADER COMMENT PREVENTS RECONVERSION, DO NOT REMOVE
"a" = (
/turf/closed/wall/r_wall,
/area/station/security/medical)
"b" = (
/obj/structure/closet{
	name = "evidence closet"
	},
/obj/effect/turf_decal/bot,
/obj/effect/turf_decal/tile/neutral/half/contrasted{
	dir = 4
	},
/obj/effect/decal/cleanable/dirt/dust,
/obj/effect/spawner/random/contraband/cannabis,
/turf/open/floor/iron/dark/textured_large,
/area/station/security/evidence)
"c" = (
/turf/closed/wall/r_wall,
/area/station/maintenance/department/security/greater)
"d" = (
/obj/structure/sign/directions/evac{
	pixel_y = -24
	},
/turf/closed/wall/r_wall,
/area/station/security/evidence)
"e" = (
/obj/effect/turf_decal/tile/red/half/contrasted{
	dir = 8
	},
/obj/effect/turf_decal/tile/neutral{
	dir = 1
	},
/turf/open/floor/iron,
/area/station/security/brig)
"f" = (
/obj/effect/turf_decal/tile/red/half/contrasted{
	dir = 8
	},
/obj/effect/turf_decal/tile/neutral{
	dir = 1
	},
/obj/structure/sign/poster/official/get_your_legs/directional/west,
/turf/open/floor/iron,
/area/station/security/brig)
"g" = (
/obj/machinery/light/directional/east{
	dir = 8
	},
/obj/structure/table/reinforced,
/obj/machinery/computer/records/medical/laptop{
	dir = 4;
	pixel_x = 4;
	pixel_y = 2
	},
/obj/machinery/wall_healer/directional/west,
/obj/item/reagent_containers/cup/bottle/multiver{
	pixel_x = -8;
	pixel_y = -8
	},
/obj/item/reagent_containers/cup/bottle/epinephrine{
	pixel_x = -3;
	pixel_y = -8
	},
/obj/effect/turf_decal/tile/blue/half{
	dir = 8
	},
/turf/open/floor/iron/white,
/area/station/security/medical)
"h" = (
/obj/structure/closet{
	name = "evidence closet"
	},
/obj/effect/turf_decal/bot,
/obj/effect/turf_decal/tile/neutral{
	dir = 4
	},
/obj/effect/decal/cleanable/dirt/dust,
/turf/open/floor/iron/dark/textured_large,
/area/station/security/evidence)
"j" = (
/turf/closed/wall/r_wall,
/area/station/security/evidence)
"k" = (
/obj/machinery/door/window/brigdoor/left/directional/east{
	name = "Security Medical"
	},
/obj/machinery/atmospherics/pipe/smart/manifold4w/supply/hidden/layer4,
/obj/structure/cable,
/obj/machinery/atmospherics/pipe/smart/manifold4w/scrubbers/hidden/layer2,
/obj/effect/turf_decal/tile/blue/half{
	dir = 4
	},
/turf/open/floor/iron/white,
/area/station/security/medical)
"m" = (
/obj/effect/turf_decal/tile/red/half/contrasted{
	dir = 8
	},
/obj/effect/turf_decal/tile/neutral{
	dir = 1
	},
/obj/machinery/atmospherics/components/unary/vent_pump/on/layer4{
	dir = 4
	},
/obj/effect/turf_decal/box,
/obj/machinery/firealarm/directional/west,
/turf/open/floor/iron,
/area/station/security/brig)
"o" = (
/obj/effect/turf_decal/tile/neutral/fourcorners,
/turf/open/floor/iron,
/area/station/security/brig)
"r" = (
/obj/effect/turf_decal/tile/neutral/half/contrasted{
	dir = 8
	},
/obj/machinery/light_switch/directional/east,
/obj/effect/decal/cleanable/dirt/dust,
/obj/structure/rack,
/turf/open/floor/iron/dark/textured_large,
/area/station/security/evidence)
"s" = (
/obj/structure/table/reinforced,
/obj/item/paper_bin{
	pixel_x = -7;
	pixel_y = 3
	},
/obj/item/folder/white{
	pixel_x = 11;
	pixel_y = 0
	},
/obj/item/folder/red{
	pixel_x = 7;
	pixel_y = 0
	},
/obj/item/pen{
	pixel_x = -7;
	pixel_y = 5
	},
/obj/item/reagent_containers/cup/glass/mug/nanotrasen{
	pixel_x = 8;
	pixel_y = 14
	},
/obj/item/reagent_containers/syringe{
	pixel_x = -8;
	pixel_y = 13
	},
/obj/effect/turf_decal/tile/blue/anticorner{
	dir = 8
	},
/obj/machinery/vending/wallmed/directional/west,
/turf/open/floor/iron/white,
/area/station/security/medical)
"t" = (
/obj/machinery/camera/directional/east{
	c_tag = "Security Infirmary";
	dir = 5;
	name = "security medical camera"
	},
/obj/structure/table/reinforced,
/obj/machinery/computer/crew{
	dir = 1
	},
/obj/machinery/power/apc/auto_name/directional/south,
/obj/structure/cable,
/obj/effect/turf_decal/tile/blue/half,
/turf/open/floor/iron/white,
/area/station/security/medical)
"u" = (
/obj/machinery/atmospherics/components/unary/vent_pump/on/layer4,
/obj/effect/turf_decal/tile/neutral/fourcorners,
/obj/effect/turf_decal/box,
/turf/open/floor/iron/dark/textured_large,
/area/station/security/evidence)
"v" = (
/obj/effect/turf_decal/tile/neutral/half/contrasted{
	dir = 4
	},
/obj/effect/turf_decal/bot,
/obj/structure/closet/secure_closet/evidence,
/turf/open/floor/iron/dark/textured_large,
/area/station/security/evidence)
"w" = (
/obj/effect/turf_decal/tile/neutral/fourcorners,
/obj/machinery/atmospherics/pipe/smart/manifold4w/supply/hidden/layer4,
/turf/open/floor/iron,
/area/station/security/brig)
"x" = (
/obj/effect/turf_decal/tile/red/half/contrasted{
	dir = 8
	},
/obj/effect/turf_decal/tile/neutral{
	dir = 1
	},
/obj/machinery/atmospherics/pipe/smart/manifold4w/scrubbers/hidden/layer2,
/obj/machinery/atmospherics/pipe/smart/manifold4w/supply/hidden/layer4,
/obj/structure/cable,
/turf/open/floor/iron,
/area/station/security/brig)
"y" = (
/obj/effect/turf_decal/tile/neutral/half/contrasted{
	dir = 8
	},
/obj/machinery/atmospherics/pipe/smart/manifold4w/scrubbers/hidden/layer2,
/obj/machinery/atmospherics/pipe/smart/manifold4w/supply/hidden/layer4,
/obj/structure/cable,
/turf/open/floor/iron/dark/textured_large,
/area/station/security/evidence)
"B" = (
/obj/effect/turf_decal/tile/red/half/contrasted{
	dir = 8
	},
/obj/effect/turf_decal/tile/neutral{
	dir = 1
	},
/obj/machinery/status_display/evac/directional/west,
/turf/open/floor/iron,
/area/station/security/brig)
"C" = (
/obj/effect/turf_decal/tile/red/half/contrasted{
	dir = 8
	},
/obj/effect/turf_decal/tile/neutral{
	dir = 1
	},
/obj/machinery/atmospherics/components/unary/vent_scrubber/on/layer2{
	dir = 1
	},
/obj/effect/turf_decal/box,
/obj/machinery/light/directional/west,
/turf/open/floor/iron,
/area/station/security/brig)
"D" = (
/obj/effect/turf_decal/tile/neutral/fourcorners,
/obj/machinery/atmospherics/pipe/smart/manifold4w/scrubbers/hidden/layer2,
/obj/machinery/atmospherics/pipe/smart/manifold4w/supply/hidden/layer4,
/obj/structure/cable,
/turf/open/floor/iron,
/area/station/security/brig)
"E" = (
/obj/effect/turf_decal/tile/neutral/fourcorners,
/obj/effect/decal/cleanable/dirt/dust,
/obj/machinery/atmospherics/pipe/smart/manifold4w/scrubbers/hidden/layer2,
/obj/machinery/atmospherics/pipe/smart/manifold4w/supply/hidden/layer4,
/turf/open/floor/iron/dark/textured_large,
/area/station/security/evidence)
"F" = (
/obj/effect/turf_decal/tile/neutral/half/contrasted{
	dir = 8
	},
/obj/machinery/power/apc/auto_name/directional/east,
/obj/machinery/camera/directional/east{
	c_tag = "Evidence Closet";
	name = "evidence camera"
	},
/obj/structure/cable,
/turf/open/floor/iron/dark/textured_large,
/area/station/security/evidence)
"G" = (
/obj/structure/closet/secure_closet/evidence,
/obj/effect/turf_decal/bot,
/obj/effect/turf_decal/tile/neutral,
/obj/effect/spawner/random/contraband/permabrig_weapon,
/obj/effect/spawner/random/contraband/permabrig_gear,
/turf/open/floor/iron/dark/textured_large,
/area/station/security/evidence)
"H" = (
/obj/structure/window/reinforced/spawner/directional/east,
/obj/structure/closet/secure_closet/security_medic,
/obj/machinery/atmospherics/components/unary/vent_scrubber/on/layer2{
	dir = 1
	},
/obj/item/reagent_containers/spray/cleaner,
/obj/item/storage/medkit/regular,
/obj/effect/turf_decal/tile/blue/anticorner,
/obj/item/emergency_bed,
/obj/item/emergency_bed,
/turf/open/floor/iron/white,
/area/station/security/medical)
"J" = (
/obj/effect/turf_decal/tile/neutral{
	dir = 1
	},
/obj/structure/table,
/obj/item/hand_labeler,
/obj/item/stack/package_wrap,
/turf/open/floor/iron/dark/textured_large,
/area/station/security/evidence)
"K" = (
/obj/structure/table/reinforced,
/obj/machinery/computer/operating,
/obj/machinery/defibrillator_mount/directional/north,
/obj/effect/turf_decal/tile/blue/half{
	dir = 1
	},
/turf/open/floor/iron/white,
/area/station/security/medical)
"M" = (
/turf/template_noop,
/area/template_noop)
"O" = (
/obj/machinery/atmospherics/components/unary/vent_scrubber/on/layer2{
	dir = 1
	},
/obj/effect/turf_decal/tile/neutral/fourcorners,
/obj/effect/turf_decal/box,
/turf/open/floor/iron/dark/textured_large,
/area/station/security/evidence)
"P" = (
/obj/effect/turf_decal/tile/neutral/half/contrasted{
	dir = 4
	},
/obj/effect/turf_decal/bot,
/obj/structure/closet/secure_closet/evidence,
/obj/effect/decal/cleanable/dirt/dust,
/obj/effect/spawner/random/contraband/narcotics,
/turf/open/floor/iron/dark/textured_large,
/area/station/security/evidence)
"Q" = (
/obj/effect/decal/cleanable/cobweb/cobweb2,
/obj/effect/turf_decal/tile/neutral{
	dir = 8
	},
/obj/machinery/firealarm/directional/east,
/obj/effect/decal/cleanable/dirt/dust,
/obj/structure/filingcabinet/security,
/turf/open/floor/iron/dark/textured_large,
/area/station/security/evidence)
"R" = (
/obj/machinery/light/small/directional/south,
/obj/effect/turf_decal/tile/neutral/half/contrasted{
	dir = 1
	},
/turf/open/floor/iron/dark/textured_large,
/area/station/security/evidence)
"S" = (
/obj/machinery/light/small/directional/north,
/obj/effect/turf_decal/tile/neutral/half/contrasted,
/obj/machinery/airalarm/directional/east{
	pixel_x = 0;
	pixel_y = 27
	},
/turf/open/floor/iron/dark/textured_large,
/area/station/security/evidence)
"T" = (
/obj/structure/sign/poster/official/moth_epi/directional/west,
/obj/structure/table/reinforced,
/obj/effect/spawner/surgery_tray/full,
/obj/machinery/airalarm/directional/north,
/obj/item/healthanalyzer{
	pixel_y = -10;
	pixel_x = -7
	},
/obj/effect/turf_decal/tile/blue/anticorner{
	dir = 1
	},
/turf/open/floor/iron/white,
/area/station/security/medical)
"U" = (
/obj/effect/landmark/start/security_medic,
/obj/structure/cable,
/obj/structure/chair/office/light{
	dir = 8
	},
/turf/open/floor/iron/white,
/area/station/security/medical)
"V" = (
/obj/effect/turf_decal/tile/red/half/contrasted{
	dir = 8
	},
/obj/effect/turf_decal/tile/neutral{
	dir = 1
	},
/obj/machinery/atmospherics/pipe/smart/manifold4w/supply/hidden/layer4,
/obj/machinery/atmospherics/pipe/smart/manifold4w/scrubbers/hidden/layer2,
/obj/structure/cable,
/turf/open/floor/iron,
/area/station/security/brig)
"X" = (
/obj/effect/turf_decal/tile/red/half/contrasted{
	dir = 8
	},
/obj/effect/turf_decal/tile/neutral{
	dir = 1
	},
/obj/structure/sign/departments/medbay/alt{
	pixel_x = -32
	},
/turf/open/floor/iron,
/area/station/security/brig)
"Y" = (
/obj/structure/window/reinforced/spawner/directional/east,
/obj/structure/table/optable,
/obj/machinery/vitals_reader/directional/north,
/obj/machinery/atmospherics/components/unary/vent_pump/on/layer4,
/obj/item/clothing/gloves/latex,
/obj/item/clothing/mask/surgical,
/obj/effect/turf_decal/tile/blue/anticorner{
	dir = 4
	},
/turf/open/floor/iron/white,
/area/station/security/medical)
"Z" = (
/obj/machinery/door/airlock/security{
	name = "Evidence"
	},
/obj/effect/mapping_helpers/airlock/access/all/security/general,
/obj/machinery/door/firedoor,
/obj/machinery/atmospherics/pipe/smart/manifold4w/scrubbers/hidden/layer2,
/obj/machinery/atmospherics/pipe/smart/manifold4w/supply/hidden/layer4,
/obj/structure/cable,
/turf/open/floor/iron/dark,
/area/station/security/evidence)

(1,1,1) = {"
M
M
M
M
j
j
j
j
d
j
j
"}
(2,1,1) = {"
c
c
c
c
j
G
P
v
b
h
j
"}
(3,1,1) = {"
a
T
g
s
a
S
u
E
O
R
j
"}
(4,1,1) = {"
a
K
U
t
a
Q
r
y
F
J
j
"}
(5,1,1) = {"
a
Y
k
H
a
j
j
Z
j
j
j
"}
(6,1,1) = {"
M
M
V
e
X
B
e
x
C
f
m
"}
(7,1,1) = {"
M
M
D
M
M
M
o
D
M
M
w
"}
