//MAP CONVERTED BY dmm2tgm.py THIS HEADER COMMENT PREVENTS RECONVERSION, DO NOT REMOVE
"a" = (
/obj/machinery/door/airlock/maintenance{
	name = "Brig Infirmary Maintenance"
	},
/obj/structure/cable,
/obj/machinery/atmospherics/pipe/smart/manifold4w/scrubbers/hidden/layer2,
/obj/machinery/atmospherics/pipe/smart/manifold4w/cyan/hidden/layer4,
/obj/effect/mapping_helpers/airlock/access/any/security/entrance,
/turf/open/floor/plating,
/area/station/maintenance/department/security/brig)
"b" = (
/obj/effect/turf_decal/trimline/blue/filled/line{
	dir = 1
	},
/obj/machinery/computer/crew,
/obj/structure/table/reinforced,
/obj/effect/turf_decal/trimline/blue/filled/corner{
	dir = 8
	},
/obj/effect/turf_decal/trimline/dark/line{
	dir = 1
	},
/obj/machinery/status_display/evac/directional/north,
/turf/open/floor/iron/white,
/area/station/security/medical)
"c" = (
/turf/closed/wall/r_wall,
/area/station/maintenance/department/security/brig)
"d" = (
/obj/effect/turf_decal/trimline/blue/filled/line{
	dir = 6
	},
/obj/structure/window/reinforced/spawner/directional/east,
/obj/structure/table/reinforced/rglass,
/obj/item/reagent_containers/spray/cleaner{
	pixel_x = 6;
	pixel_y = 16
	},
/obj/item/reagent_containers/cup/bottle/epinephrine{
	pixel_x = -7;
	pixel_y = 14
	},
/obj/item/reagent_containers/cup/bottle/multiver{
	pixel_x = -2;
	pixel_y = 14
	},
/obj/item/reagent_containers/syringe{
	pixel_x = -4;
	pixel_y = -4
	},
/obj/item/storage/box/bandages{
	pixel_x = -6;
	pixel_y = 0
	},
/obj/item/storage/medkit/regular{
	pixel_x = 3;
	pixel_y = 2
	},
/obj/machinery/atmospherics/pipe/smart/manifold4w/cyan/hidden/layer4,
/obj/machinery/atmospherics/pipe/smart/manifold4w/scrubbers/hidden/layer2,
/obj/effect/turf_decal/trimline/dark/line{
	dir = 6
	},
/turf/open/floor/iron/white,
/area/station/security/medical)
"e" = (
/obj/effect/turf_decal/trimline/blue/filled/line{
	dir = 8
	},
/obj/structure/table/optable,
/obj/effect/turf_decal/trimline/blue/filled/corner,
/obj/machinery/defibrillator_mount/directional/west,
/obj/effect/turf_decal/trimline/dark/line{
	dir = 8
	},
/turf/open/floor/iron/white,
/area/station/security/medical)
"f" = (
/obj/structure/chair/office/light{
	dir = 4
	},
/obj/effect/turf_decal/trimline/blue/filled/line{
	dir = 10
	},
/obj/effect/landmark/start/security_medic,
/turf/open/floor/iron/white,
/area/station/security/medical)
"i" = (
/obj/effect/turf_decal/trimline/blue/filled/line{
	dir = 5
	},
/turf/open/floor/iron/white,
/area/station/security/medical)
"j" = (
/obj/effect/turf_decal/trimline/blue/filled/line{
	dir = 8
	},
/obj/machinery/computer/operating{
	dir = 4
	},
/obj/machinery/light/directional/west,
/obj/effect/turf_decal/trimline/blue/filled/corner{
	dir = 4
	},
/obj/machinery/atmospherics/components/unary/vent_pump/on/layer4,
/obj/effect/turf_decal/trimline/dark/line{
	dir = 8
	},
/obj/machinery/newscaster/directional/west,
/turf/open/floor/iron/white,
/area/station/security/medical)
"l" = (
/turf/closed/wall,
/area/station/security/medical)
"m" = (
/turf/closed/wall/r_wall,
/area/station/security/medical)
"q" = (
/obj/machinery/door/poddoor/preopen{
	id = "Prison Gate";
	name = "Prison Blast Door"
	},
/obj/effect/turf_decal/delivery,
/turf/open/floor/iron,
/area/station/security/brig)
"r" = (
/obj/structure/cable,
/obj/effect/turf_decal/trimline/blue/filled/line,
/obj/effect/turf_decal/tile/red{
	dir = 8
	},
/obj/machinery/stasis,
/obj/item/bedsheet,
/obj/machinery/iv_drip,
/obj/effect/turf_decal/trimline/blue/filled/corner{
	dir = 1
	},
/obj/machinery/wall_healer/directional/south,
/obj/machinery/atmospherics/pipe/smart/manifold4w/cyan/hidden/layer4,
/obj/machinery/atmospherics/pipe/smart/manifold4w/scrubbers/hidden/layer2,
/obj/effect/turf_decal/trimline/dark/line,
/turf/open/floor/iron/white,
/area/station/security/medical)
"s" = (
/obj/effect/turf_decal/tile/red/half/contrasted{
	dir = 8
	},
/turf/open/floor/iron,
/area/station/security/brig)
"t" = (
/obj/structure/cable,
/obj/effect/turf_decal/trimline/blue/filled/line{
	dir = 9
	},
/turf/open/floor/iron/white,
/area/station/security/medical)
"w" = (
/turf/closed/wall,
/area/station/security/brig)
"x" = (
/obj/effect/turf_decal/trimline/blue/filled/line{
	dir = 6
	},
/obj/effect/landmark/start/security_medic,
/turf/open/floor/iron/white,
/area/station/security/medical)
"y" = (
/obj/machinery/light/directional/west,
/obj/effect/turf_decal/tile/red/half/contrasted{
	dir = 8
	},
/obj/structure/sign/map/pubby{
	pixel_x = -32
	},
/turf/open/floor/iron,
/area/station/security/brig)
"z" = (
/obj/structure/cable,
/obj/effect/turf_decal/trimline/blue/filled/line,
/obj/structure/sink/directional/north,
/obj/effect/turf_decal/trimline/blue/filled/corner{
	dir = 4
	},
/obj/machinery/atmospherics/pipe/smart/manifold4w/cyan/hidden/layer4,
/obj/machinery/atmospherics/pipe/smart/manifold4w/scrubbers/hidden/layer2,
/obj/machinery/airalarm/directional/south,
/obj/effect/turf_decal/trimline/dark/line,
/turf/open/floor/iron/white,
/area/station/security/medical)
"A" = (
/obj/machinery/door/window/right/directional/east{
	name = "Brig Infirmary"
	},
/obj/structure/cable,
/obj/machinery/atmospherics/components/unary/vent_scrubber/on/layer2,
/obj/effect/turf_decal/trimline/blue/filled/corner{
	dir = 1
	},
/obj/effect/turf_decal/trimline/blue/filled/corner,
/obj/effect/turf_decal/trimline/blue/filled/corner{
	dir = 4
	},
/obj/effect/turf_decal/trimline/dark/corner,
/obj/effect/turf_decal/trimline/dark/corner{
	dir = 4
	},
/turf/open/floor/iron/white,
/area/station/security/medical)
"I" = (
/obj/machinery/atmospherics/pipe/smart/manifold4w/scrubbers/hidden/layer2,
/obj/machinery/atmospherics/pipe/smart/manifold4w/cyan/hidden/layer4,
/obj/effect/turf_decal/tile/red/half/contrasted{
	dir = 8
	},
/turf/open/floor/iron,
/area/station/security/brig)
"M" = (
/obj/structure/cable,
/obj/effect/turf_decal/trimline/blue/filled/line{
	dir = 10
	},
/obj/machinery/atmospherics/pipe/smart/manifold4w/cyan/hidden/layer4,
/obj/machinery/atmospherics/pipe/smart/manifold4w/scrubbers/hidden/layer2,
/obj/machinery/camera/directional/west{
	c_tag = "Brig Infirmary"
	},
/obj/effect/turf_decal/trimline/dark/line{
	dir = 10
	},
/turf/open/floor/iron/white,
/area/station/security/medical)
"N" = (
/obj/effect/turf_decal/trimline/blue/filled/line{
	dir = 5
	},
/obj/structure/window/reinforced/spawner/directional/east,
/obj/structure/table/reinforced,
/obj/item/paper_bin{
	pixel_x = 2;
	pixel_y = 5
	},
/obj/item/pen{
	pixel_x = 3;
	pixel_y = 6
	},
/obj/item/folder/red{
	pixel_x = -2;
	pixel_y = -12
	},
/obj/item/reagent_containers/cup/glass/mug/nanotrasen{
	pixel_x = -12;
	pixel_y = 7
	},
/obj/item/folder/white{
	pixel_x = 2;
	pixel_y = -12
	},
/obj/item/healthanalyzer{
	pixel_x = -8;
	pixel_y = -4
	},
/obj/machinery/power/apc/auto_name/directional/north,
/obj/structure/cable,
/obj/effect/turf_decal/trimline/dark/line{
	dir = 5
	},
/turf/open/floor/iron/white,
/area/station/security/medical)
"R" = (
/obj/effect/turf_decal/trimline/blue/filled/line{
	dir = 1
	},
/obj/structure/closet/secure_closet/security_medic,
/obj/effect/turf_decal/trimline/blue/filled/corner,
/obj/effect/turf_decal/trimline/dark/line{
	dir = 1
	},
/obj/item/radio/intercom/directional/north,
/turf/open/floor/iron/white,
/area/station/security/medical)
"T" = (
/obj/structure/cable,
/obj/effect/turf_decal/trimline/red/filled/warning{
	dir = 8
	},
/turf/open/floor/iron,
/area/station/security/brig)
"U" = (
/obj/effect/turf_decal/trimline/blue/filled/line{
	dir = 9
	},
/obj/structure/table/reinforced/rglass,
/obj/effect/spawner/surgery_tray/full,
/obj/machinery/vitals_reader/directional/west,
/obj/effect/turf_decal/trimline/dark/line{
	dir = 9
	},
/obj/structure/extinguisher_cabinet/directional/north,
/turf/open/floor/iron/white,
/area/station/security/medical)
"Z" = (
/obj/effect/turf_decal/trimline/blue/filled/line{
	dir = 4
	},
/obj/structure/window/reinforced/spawner/directional/east,
/obj/machinery/computer/records/medical/laptop{
	dir = 8;
	pixel_y = 3;
	pixel_x = -4
	},
/obj/structure/table/reinforced,
/obj/effect/turf_decal/trimline/blue/filled/corner{
	dir = 8
	},
/obj/structure/cable,
/obj/effect/turf_decal/trimline/dark/line{
	dir = 4
	},
/turf/open/floor/iron/white,
/area/station/security/medical)

(1,1,1) = {"
m
m
m
m
m
c
"}
(2,1,1) = {"
l
U
e
j
M
a
"}
(3,1,1) = {"
l
R
x
i
z
c
"}
(4,1,1) = {"
l
b
f
t
r
w
"}
(5,1,1) = {"
l
N
Z
A
d
w
"}
(6,1,1) = {"
q
s
s
T
I
y
"}
