//MAP CONVERTED BY dmm2tgm.py THIS HEADER COMMENT PREVENTS RECONVERSION, DO NOT REMOVE
"a" = (
/turf/closed/wall/r_wall,
/area/station/security/prison)
"f" = (
/obj/effect/turf_decal/stripes/white/line{
	dir = 1
	},
/obj/structure/closet,
/obj/item/reagent_containers/cup/bottle/morphine,
/obj/item/reagent_containers/cup/bottle/morphine,
/obj/item/reagent_containers/syringe,
/turf/open/floor/iron/dark,
/area/station/security/prison)
"g" = (
/obj/structure/closet,
/obj/item/clothing/suit/jacket/straight_jacket,
/obj/item/clothing/suit/jacket/straight_jacket,
/obj/item/clothing/mask/muzzle,
/obj/item/clothing/mask/muzzle,
/obj/item/clothing/glasses/blindfold,
/obj/item/clothing/glasses/blindfold,
/obj/structure/sign/departments/medbay/alt/directional/south,
/turf/open/floor/iron/dark,
/area/station/security/prison)
"i" = (
/obj/effect/turf_decal/stripes/white/line{
	dir = 1
	},
/obj/machinery/atmospherics/components/unary/vent_scrubber/on/layer2{
	dir = 1
	},
/turf/open/floor/iron/dark,
/area/station/security/prison)
"j" = (
/obj/structure/table,
/obj/effect/turf_decal/trimline/blue/filled/line{
	dir = 10
	},
/obj/item/paper/fluff/jobs/medical/blood_types,
/obj/item/reagent_containers/blood/o_minus{
	pixel_x = -6;
	pixel_y = 0
	},
/obj/item/reagent_containers/blood/o_minus,
/obj/item/reagent_containers/blood/lizard{
	pixel_x = 6;
	pixel_y = 0
	},
/obj/structure/sign/poster/official/moth_epi/directional/south,
/turf/open/floor/iron/white,
/area/station/security/prison)
"k" = (
/obj/effect/turf_decal/trimline/blue/filled/line,
/obj/machinery/light/directional/south,
/obj/machinery/wall_healer/free/directional/south,
/turf/open/floor/iron/white,
/area/station/security/prison)
"m" = (
/obj/machinery/door/airlock/security/glass{
	name = "Prison Sanitarium"
	},
/obj/machinery/door/firedoor,
/obj/effect/turf_decal/trimline/blue/filled/warning{
	dir = 4
	},
/obj/machinery/atmospherics/pipe/smart/manifold4w/scrubbers/hidden/layer2,
/obj/machinery/atmospherics/pipe/smart/manifold4w/supply/hidden/layer4,
/obj/effect/mapping_helpers/airlock/access/all/security/brig,
/turf/open/floor/iron/dark,
/area/station/security/prison)
"r" = (
/obj/effect/turf_decal/trimline/blue/filled/line,
/obj/effect/turf_decal/trimline/blue/filled/line{
	dir = 1
	},
/obj/machinery/atmospherics/pipe/smart/manifold4w/scrubbers/hidden/layer2,
/turf/open/floor/iron/white,
/area/station/security/prison)
"t" = (
/obj/machinery/atmospherics/pipe/smart/manifold4w/scrubbers/hidden/layer2,
/obj/machinery/atmospherics/pipe/smart/manifold4w/supply/hidden/layer4,
/obj/structure/sink/directional/west,
/obj/structure/sign/poster/official/cleanliness/directional/east,
/obj/effect/turf_decal/trimline/blue/filled/end{
	dir = 4
	},
/turf/open/floor/iron/white,
/area/station/security/prison)
"u" = (
/obj/effect/turf_decal/trimline/blue/filled/line{
	dir = 1
	},
/obj/machinery/atmospherics/pipe/smart/manifold4w/scrubbers/hidden/layer2,
/obj/machinery/atmospherics/pipe/smart/manifold4w/supply/hidden/layer4,
/obj/effect/turf_decal/trimline/blue/filled/corner{
	dir = 8
	},
/obj/effect/turf_decal/trimline/blue/filled/corner,
/turf/open/floor/iron/white,
/area/station/security/prison)
"y" = (
/obj/effect/turf_decal/trimline/blue/filled/end{
	dir = 8
	},
/turf/open/floor/iron/white,
/area/station/security/prison)
"B" = (
/obj/structure/window/reinforced/spawner/directional/east{
	pixel_x = 3;
	pixel_y = 0
	},
/obj/effect/turf_decal/stripes/white/line{
	dir = 10
	},
/obj/structure/rack/shelf,
/obj/item/stack/medical/mesh,
/obj/item/stack/medical/mesh,
/obj/item/stack/medical/suture,
/obj/item/stack/medical/suture,
/obj/item/stack/medical/wrap/gauze/twelve,
/obj/item/healthanalyzer/simple,
/obj/structure/window/reinforced/survival_pod/spawner/directional/south{
	dir = 5;
	pixel_x = 3;
	pixel_y = 4
	},
/turf/open/floor/iron/dark,
/area/station/security/prison)
"C" = (
/obj/structure/bed/medical/anchored{
	dir = 1
	},
/obj/item/bedsheet/medical,
/obj/structure/window/reinforced/spawner/directional/north{
	pixel_x = 0;
	pixel_y = 4
	},
/obj/machinery/iv_drip,
/obj/effect/turf_decal/trimline/blue/filled/line{
	dir = 5
	},
/turf/open/floor/iron/white,
/area/station/security/prison)
"D" = (
/obj/machinery/door/firedoor,
/obj/machinery/door/airlock/security/glass{
	name = "Prison Sanitarium"
	},
/obj/machinery/atmospherics/pipe/smart/manifold4w/supply/hidden/layer4,
/obj/machinery/atmospherics/pipe/smart/manifold4w/scrubbers/hidden/layer2,
/obj/effect/mapping_helpers/airlock/access/all/security/brig,
/turf/open/floor/iron/white/side,
/area/station/security/prison)
"G" = (
/obj/effect/spawner/structure/window/reinforced,
/obj/structure/cable,
/turf/open/floor/plating,
/area/station/security/prison)
"H" = (
/obj/effect/turf_decal/trimline/blue/filled/line{
	dir = 1
	},
/obj/machinery/atmospherics/pipe/smart/manifold4w/scrubbers/hidden/layer2,
/obj/machinery/firealarm/directional/north,
/obj/effect/turf_decal/trimline/blue/filled/line,
/turf/open/floor/iron/white,
/area/station/security/prison)
"I" = (
/obj/machinery/light/directional/south,
/obj/machinery/camera/directional/south,
/obj/machinery/vending/wallmed/directional/south,
/turf/open/floor/iron/dark,
/area/station/security/prison)
"K" = (
/obj/machinery/atmospherics/components/unary/vent_pump/on/layer4{
	dir = 1
	},
/obj/effect/turf_decal/trimline/blue/filled/corner{
	dir = 1
	},
/obj/effect/turf_decal/trimline/blue/filled/corner{
	dir = 4
	},
/turf/open/floor/iron/white,
/area/station/security/prison)
"P" = (
/obj/structure/bed/medical/anchored{
	dir = 1
	},
/obj/item/bedsheet/medical,
/obj/effect/turf_decal/trimline/blue/filled/line{
	dir = 6
	},
/obj/machinery/iv_drip,
/obj/structure/sign/departments/medbay/alt/directional/south,
/turf/open/floor/iron/white,
/area/station/security/prison)
"Q" = (
/obj/structure/window/reinforced/spawner/directional/east{
	pixel_x = 3;
	pixel_y = 0
	},
/obj/effect/turf_decal/stripes/white/line{
	dir = 4
	},
/obj/structure/rack/shelf,
/obj/item/stack/medical/mesh,
/obj/item/stack/medical/mesh,
/obj/item/stack/medical/suture,
/obj/item/stack/medical/suture,
/obj/item/stack/medical/wrap/gauze/twelve,
/obj/item/healthanalyzer/simple,
/obj/item/radio/intercom/directional/south,
/turf/open/floor/iron/dark,
/area/station/security/prison)
"S" = (
/obj/structure/table,
/obj/structure/window/reinforced/spawner/directional/north{
	pixel_x = 0;
	pixel_y = 4
	},
/obj/machinery/computer/records/medical/laptop{
	dir = 4;
	pixel_x = 3;
	pixel_y = 2
	},
/obj/effect/turf_decal/trimline/blue/filled/line{
	dir = 9
	},
/turf/open/floor/iron/white,
/area/station/security/prison)

(1,1,1) = {"
a
m
a
a
a
"}
(2,1,1) = {"
G
y
f
g
a
"}
(3,1,1) = {"
G
r
i
I
a
"}
(4,1,1) = {"
G
r
B
Q
a
"}
(5,1,1) = {"
a
H
S
j
a
"}
(6,1,1) = {"
a
u
K
k
a
"}
(7,1,1) = {"
D
t
C
P
a
"}
(8,1,1) = {"
a
a
a
a
a
"}
