//MAP CONVERTED BY dmm2tgm.py THIS HEADER COMMENT PREVENTS RECONVERSION, DO NOT REMOVE
"a" = (
/obj/effect/turf_decal/siding/dark_red{
	dir = 1
	},
/obj/structure/bed/medical/emergency,
/obj/machinery/iv_drip,
/obj/machinery/airalarm/directional/south,
/turf/open/floor/iron/dark/small,
/area/station/security/execution/transfer)
"c" = (
/obj/effect/turf_decal/trimline/dark_red/filled/corner{
	dir = 4
	},
/obj/effect/turf_decal/trimline/dark_red/filled/corner{
	dir = 1
	},
/obj/effect/turf_decal/trimline/dark/corner{
	dir = 4
	},
/obj/effect/turf_decal/trimline/dark/corner{
	dir = 1
	},
/obj/machinery/atmospherics/components/unary/vent_scrubber/on/layer2,
/turf/open/floor/iron/white,
/area/station/security/execution/transfer)
"e" = (
/obj/effect/turf_decal/siding/dark_red{
	dir = 4
	},
/obj/structure/closet,
/obj/item/clothing/suit/jacket/straight_jacket,
/obj/item/clothing/suit/jacket/straight_jacket,
/obj/item/clothing/mask/muzzle,
/obj/item/clothing/mask/muzzle,
/obj/item/clothing/glasses/blindfold,
/obj/item/clothing/glasses/blindfold,
/turf/open/floor/iron/dark/small,
/area/station/security/execution/transfer)
"j" = (
/obj/effect/turf_decal/trimline/dark_red/filled/line{
	dir = 6
	},
/obj/effect/turf_decal/trimline/dark/line{
	dir = 6
	},
/turf/open/floor/iron/white,
/area/station/security/execution/transfer)
"l" = (
/obj/effect/turf_decal/siding/dark_red,
/obj/structure/bed/medical{
	dir = 4
	},
/obj/item/radio/intercom/directional/north,
/obj/machinery/firealarm/directional/east,
/turf/open/floor/iron/dark/small,
/area/station/security/execution/transfer)
"m" = (
/obj/effect/turf_decal/siding/dark_red,
/obj/machinery/wall_healer/directional/north,
/obj/machinery/light/directional/north,
/obj/structure/table/reinforced/rglass,
/obj/item/reagent_containers/cup/bottle/morphine{
	pixel_x = -2;
	pixel_y = 11
	},
/obj/item/reagent_containers/cup/bottle/morphine{
	pixel_x = -8;
	pixel_y = 11
	},
/obj/item/reagent_containers/syringe{
	pixel_x = -6;
	pixel_y = -1
	},
/obj/item/stack/medical/ointment{
	pixel_x = 10;
	pixel_y = -4
	},
/obj/item/stack/medical/bruise_pack{
	pixel_x = 9;
	pixel_y = 11
	},
/turf/open/floor/iron/dark/small,
/area/station/security/execution/transfer)
"o" = (
/obj/effect/spawner/structure/window/reinforced,
/obj/structure/cable,
/turf/open/floor/plating,
/area/station/security/execution/transfer)
"p" = (
/obj/effect/turf_decal/trimline/dark_red/filled/corner,
/obj/effect/turf_decal/trimline/dark_red/filled/corner{
	dir = 8
	},
/obj/effect/turf_decal/trimline/dark/corner,
/obj/effect/turf_decal/trimline/dark/corner{
	dir = 8
	},
/obj/machinery/atmospherics/components/unary/vent_pump/on/layer4{
	dir = 1
	},
/turf/open/floor/iron/white,
/area/station/security/execution/transfer)
"q" = (
/obj/effect/turf_decal/trimline/dark_red/filled/line{
	dir = 10
	},
/obj/effect/turf_decal/trimline/dark/line{
	dir = 10
	},
/turf/open/floor/iron/white,
/area/station/security/execution/transfer)
"r" = (
/obj/effect/turf_decal/trimline/dark_red/filled/line{
	dir = 5
	},
/obj/effect/turf_decal/trimline/dark/line{
	dir = 5
	},
/turf/open/floor/iron/white,
/area/station/security/execution/transfer)
"w" = (
/turf/closed/wall/r_wall,
/area/station/security/execution/transfer)
"y" = (
/obj/effect/turf_decal/trimline/dark_red/filled/corner{
	dir = 8
	},
/obj/effect/turf_decal/trimline/dark_red/filled/corner{
	dir = 1
	},
/obj/structure/cable,
/obj/effect/turf_decal/trimline/dark/corner{
	dir = 8
	},
/obj/effect/turf_decal/trimline/dark/corner{
	dir = 1
	},
/turf/open/floor/iron/white,
/area/station/security/execution/transfer)
"z" = (
/obj/machinery/holopad,
/obj/structure/cable,
/obj/machinery/atmospherics/pipe/smart/manifold4w/supply/hidden/layer4,
/obj/machinery/atmospherics/pipe/smart/manifold4w/scrubbers/hidden/layer2,
/obj/effect/landmark/event_spawn,
/turf/open/floor/iron/white/textured_large,
/area/station/security/execution/transfer)
"C" = (
/obj/machinery/door/airlock/medical/glass{
	name = "Sanitarium"
	},
/obj/effect/mapping_helpers/airlock/access/all/security/brig,
/obj/effect/turf_decal/stripes/line{
	dir = 4
	},
/obj/effect/turf_decal/stripes/line{
	dir = 8
	},
/obj/structure/cable,
/obj/machinery/atmospherics/pipe/smart/manifold4w/supply/hidden/layer4,
/obj/machinery/atmospherics/pipe/smart/manifold4w/scrubbers/hidden/layer2,
/turf/open/floor/iron/white,
/area/station/security/execution/transfer)
"E" = (
/obj/effect/turf_decal/siding/dark_red,
/obj/structure/bed/medical{
	dir = 8
	},
/obj/machinery/newscaster/directional/north,
/turf/open/floor/iron/dark/small,
/area/station/security/execution/transfer)
"F" = (
/obj/effect/turf_decal/siding/dark_red{
	dir = 4
	},
/obj/structure/table/reinforced/rglass,
/obj/item/paper_bin{
	pixel_x = -7;
	pixel_y = 3
	},
/obj/item/pen{
	pixel_x = -7;
	pixel_y = 4
	},
/obj/item/folder/white{
	pixel_x = 7;
	pixel_y = 0
	},
/obj/item/folder/blue{
	pixel_x = 7;
	pixel_y = 3
	},
/obj/item/healthanalyzer{
	pixel_x = -6;
	pixel_y = 15
	},
/turf/open/floor/iron/dark/small,
/area/station/security/execution/transfer)
"I" = (
/turf/template_noop,
/area/template_noop)
"N" = (
/obj/effect/turf_decal/trimline/dark_red/filled/line{
	dir = 9
	},
/obj/effect/turf_decal/trimline/dark/line{
	dir = 9
	},
/turf/open/floor/iron/white,
/area/station/security/execution/transfer)
"Q" = (
/obj/effect/turf_decal/siding/dark_red{
	dir = 4
	},
/obj/structure/cable,
/obj/structure/table/reinforced/rglass,
/obj/machinery/computer/records/medical/laptop{
	dir = 4;
	pixel_x = 3;
	pixel_y = 3
	},
/obj/item/storage/box/bandages{
	pixel_x = -8;
	pixel_y = -13
	},
/turf/open/floor/iron/dark/small,
/area/station/security/execution/transfer)
"V" = (
/obj/effect/turf_decal/siding/dark_red{
	dir = 1
	},
/obj/structure/sign/departments/medbay/alt/directional/south,
/obj/machinery/camera/autoname/directional/south,
/obj/structure/table/reinforced/rglass,
/obj/item/reagent_containers/blood/o_minus{
	pixel_x = -4;
	pixel_y = 5
	},
/obj/item/reagent_containers/blood/o_minus{
	pixel_x = 0;
	pixel_y = 3
	},
/obj/item/reagent_containers/blood/lizard{
	pixel_x = 4;
	pixel_y = 1
	},
/obj/item/paper/fluff/jobs/medical/blood_types,
/turf/open/floor/iron/dark/small,
/area/station/security/execution/transfer)
"W" = (
/obj/effect/turf_decal/trimline/dark_red/filled/corner,
/obj/effect/turf_decal/trimline/dark_red/filled/corner{
	dir = 4
	},
/obj/structure/cable,
/obj/effect/turf_decal/trimline/dark/corner,
/obj/effect/turf_decal/trimline/dark/corner{
	dir = 4
	},
/obj/machinery/atmospherics/pipe/smart/manifold4w/supply/hidden/layer4,
/obj/machinery/atmospherics/pipe/smart/manifold4w/scrubbers/hidden/layer2,
/turf/open/floor/iron/white,
/area/station/security/execution/transfer)
"Z" = (
/obj/effect/turf_decal/siding/dark_red{
	dir = 1
	},
/obj/structure/bed/medical/emergency{
	dir = 1
	},
/obj/machinery/iv_drip,
/obj/machinery/light_switch/directional/east,
/obj/machinery/vending/wallmed/directional/south,
/turf/open/floor/iron/dark/small,
/area/station/security/execution/transfer)

(1,1,1) = {"
I
w
o
o
o
w
I
"}
(2,1,1) = {"
w
w
e
Q
F
w
w
"}
(3,1,1) = {"
w
E
N
y
q
a
w
"}
(4,1,1) = {"
w
m
c
z
p
V
w
"}
(5,1,1) = {"
w
l
r
W
j
Z
w
"}
(6,1,1) = {"
w
w
o
C
o
w
w
"}
