//MAP CONVERTED BY dmm2tgm.py THIS HEADER COMMENT PREVENTS RECONVERSION, DO NOT REMOVE
"a" = (
/obj/structure/cable,
/obj/effect/turf_decal/trimline/blue/filled/line,
/obj/machinery/atmospherics/pipe/smart/manifold4w/supply/hidden/layer4,
/obj/machinery/atmospherics/pipe/smart/manifold4w/scrubbers/hidden/layer2,
/turf/open/floor/iron/white,
/area/station/security/execution/transfer)
"f" = (
/turf/closed/wall/r_wall,
/area/station/security/execution/education)
"h" = (
/obj/structure/cable,
/obj/effect/turf_decal/trimline/blue/filled/line{
	dir = 4
	},
/turf/open/floor/iron/white,
/area/station/security/execution/transfer)
"q" = (
/obj/effect/turf_decal/trimline/blue/filled/line{
	dir = 9
	},
/obj/machinery/status_display/evac/directional/north,
/obj/machinery/airalarm/directional/west,
/obj/structure/table/reinforced/rglass,
/obj/item/reagent_containers/cup/bottle/morphine{
	pixel_x = 0;
	pixel_y = 14
	},
/obj/item/reagent_containers/cup/bottle/morphine{
	pixel_x = -7;
	pixel_y = 14
	},
/obj/item/reagent_containers/syringe{
	pixel_x = -6;
	pixel_y = -5
	},
/obj/item/healthanalyzer{
	pixel_x = -5;
	pixel_y = 3
	},
/obj/item/stack/medical/ointment{
	pixel_x = 12;
	pixel_y = -4
	},
/obj/item/stack/medical/bruise_pack{
	pixel_x = 12;
	pixel_y = 10
	},
/turf/open/floor/iron/white,
/area/station/security/execution/transfer)
"s" = (
/turf/closed/wall,
/area/station/security/execution/transfer)
"w" = (
/turf/closed/wall,
/area/station/security/execution/education)
"G" = (
/obj/machinery/camera/directional/north{
	c_tag = "Prison Sanitarium";
	network = list("ss13","prison")
	},
/obj/effect/turf_decal/trimline/blue/filled/line{
	dir = 5
	},
/obj/machinery/light/cold/directional/north,
/obj/machinery/status_display/ai/directional/north,
/obj/structure/closet,
/obj/machinery/atmospherics/components/unary/vent_pump/on/layer4{
	dir = 8
	},
/obj/item/clothing/suit/jacket/straight_jacket,
/obj/item/clothing/suit/jacket/straight_jacket,
/obj/item/clothing/mask/muzzle,
/obj/item/clothing/mask/muzzle,
/obj/item/clothing/glasses/blindfold,
/obj/item/clothing/glasses/blindfold,
/obj/item/emergency_bed,
/obj/item/emergency_bed,
/turf/open/floor/iron/white,
/area/station/security/execution/transfer)
"H" = (
/obj/effect/turf_decal/trimline/blue/filled/line{
	dir = 10
	},
/obj/machinery/firealarm/directional/west,
/obj/structure/bed/medical/anchored,
/obj/machinery/iv_drip,
/turf/open/floor/iron/white,
/area/station/security/execution/transfer)
"I" = (
/turf/closed/wall/r_wall,
/area/station/security/prison)
"N" = (
/obj/effect/turf_decal/trimline/blue/filled/line{
	dir = 6
	},
/obj/machinery/atmospherics/components/unary/vent_scrubber/on/layer2{
	dir = 8
	},
/obj/structure/rack/shelf,
/obj/item/paper/fluff/jobs/medical/blood_types,
/obj/item/reagent_containers/blood/o_minus{
	pixel_x = -4;
	pixel_y = 4
	},
/obj/item/reagent_containers/blood/o_minus{
	pixel_x = 0;
	pixel_y = 1
	},
/obj/item/reagent_containers/blood/lizard{
	pixel_x = 4;
	pixel_y = -2
	},
/turf/open/floor/iron/white,
/area/station/security/execution/transfer)
"Q" = (
/obj/effect/spawner/structure/window,
/obj/structure/cable,
/turf/open/floor/plating,
/area/station/security/execution/transfer)
"T" = (
/obj/machinery/door/airlock/security/glass{
	name = "Prison Sanitarium"
	},
/obj/structure/cable,
/obj/machinery/atmospherics/pipe/smart/manifold4w/supply/hidden/layer4,
/obj/machinery/atmospherics/pipe/smart/manifold4w/scrubbers/hidden/layer2,
/obj/machinery/door/firedoor,
/obj/effect/mapping_helpers/airlock/access/all/security/brig,
/turf/open/floor/iron,
/area/station/security/execution/transfer)
"U" = (
/obj/structure/cable,
/obj/machinery/atmospherics/pipe/smart/manifold4w/supply/hidden/layer4,
/turf/open/floor/iron/white,
/area/station/security/execution/transfer)
"V" = (
/obj/effect/turf_decal/trimline/blue/filled/line{
	dir = 8
	},
/obj/item/radio/intercom/prison/directional/west,
/obj/structure/bed/medical/anchored,
/obj/machinery/iv_drip,
/turf/open/floor/iron/white,
/area/station/security/execution/transfer)
"Z" = (
/obj/machinery/newscaster/directional/north,
/obj/effect/turf_decal/trimline/blue/filled/line{
	dir = 1
	},
/obj/structure/table/reinforced/rglass,
/obj/machinery/atmospherics/pipe/smart/manifold4w/supply/hidden/layer4,
/obj/item/folder/red{
	pixel_x = 7;
	pixel_y = 6
	},
/obj/item/folder/white{
	pixel_x = 3;
	pixel_y = 6
	},
/obj/item/paper_bin{
	pixel_x = -11;
	pixel_y = 6
	},
/obj/item/pen{
	pixel_x = -11;
	pixel_y = 8
	},
/turf/open/floor/iron/white,
/area/station/security/execution/transfer)

(1,1,1) = {"
f
f
f
I
I
"}
(2,1,1) = {"
f
q
V
H
Q
"}
(3,1,1) = {"
w
Z
U
a
T
"}
(4,1,1) = {"
s
G
h
N
Q
"}
(5,1,1) = {"
s
Q
Q
Q
Q
"}
