//MAP CONVERTED BY dmm2tgm.py THIS HEADER COMMENT PREVENTS RECONVERSION, DO NOT REMOVE
"a" = (
/obj/effect/spawner/structure/window/reinforced,
/obj/structure/cable,
/turf/open/floor/plating,
/area/station/security/execution/transfer)
"b" = (
/obj/machinery/status_display/ai/directional/west,
/obj/machinery/newscaster/directional/north,
/obj/effect/turf_decal/siding/dark_red,
/obj/item/reagent_containers/cup/bottle/morphine{
	pixel_x = -7;
	pixel_y = 14
	},
/obj/item/reagent_containers/syringe{
	pixel_x = -7;
	pixel_y = -4
	},
/obj/structure/table/reinforced/rglass,
/obj/item/reagent_containers/cup/bottle/morphine{
	pixel_x = -1;
	pixel_y = 14
	},
/obj/item/healthanalyzer{
	pixel_x = -5;
	pixel_y = 4
	},
/turf/open/floor/iron/dark,
/area/station/security/execution/transfer)
"c" = (
/obj/machinery/atmospherics/components/unary/vent_scrubber/on/layer2{
	dir = 8
	},
/obj/structure/sink/directional/west,
/obj/effect/turf_decal/tile/blue/half{
	dir = 4
	},
/obj/structure/sign/poster/official/cleanliness/directional/east,
/turf/open/floor/iron/white/side{
	dir = 8
	},
/area/station/security/execution/transfer)
"e" = (
/turf/closed/wall/r_wall,
/area/station/security/execution/transfer)
"j" = (
/obj/effect/turf_decal/tile/blue/anticorner,
/obj/structure/rack/shelf,
/obj/item/reagent_containers/blood/o_minus{
	pixel_x = -4;
	pixel_y = 0
	},
/obj/item/reagent_containers/blood/o_minus,
/obj/item/reagent_containers/blood/lizard{
	pixel_x = 4;
	pixel_y = 0
	},
/obj/item/paper/fluff/jobs/medical/blood_types,
/obj/structure/sign/poster/official/moth_epi/directional/east,
/turf/open/floor/iron/white/corner{
	dir = 1
	},
/area/station/security/execution/transfer)
"m" = (
/obj/machinery/status_display/evac/directional/east,
/obj/machinery/wall_healer/directional/north,
/obj/effect/turf_decal/siding/dark_red,
/obj/structure/table/reinforced/rglass,
/obj/item/storage/medkit/regular{
	pixel_x = 4;
	pixel_y = 9
	},
/obj/item/storage/box/bandages{
	pixel_x = 5;
	pixel_y = 0
	},
/turf/open/floor/iron/dark,
/area/station/security/execution/transfer)
"n" = (
/obj/machinery/atmospherics/pipe/smart/manifold4w/supply/hidden/layer4,
/obj/machinery/atmospherics/pipe/smart/manifold4w/scrubbers/hidden/layer2,
/turf/open/floor/iron/white,
/area/station/security/execution/transfer)
"s" = (
/obj/effect/turf_decal/tile/blue/anticorner{
	dir = 4
	},
/obj/machinery/atmospherics/components/unary/vent_pump/on/layer4{
	dir = 8
	},
/turf/open/floor/iron/white/corner{
	dir = 8
	},
/area/station/security/execution/transfer)
"y" = (
/obj/effect/turf_decal/tile/blue/half{
	dir = 1
	},
/obj/machinery/atmospherics/pipe/smart/manifold4w/supply/hidden/layer4,
/turf/open/floor/iron/white/side,
/area/station/security/execution/transfer)
"B" = (
/obj/structure/bed/medical{
	dir = 8
	},
/obj/item/clothing/suit/jacket/straight_jacket,
/obj/item/clothing/mask/muzzle,
/obj/item/clothing/glasses/blindfold,
/obj/machinery/airalarm/directional/west,
/obj/effect/turf_decal/tile/blue/anticorner{
	dir = 1
	},
/turf/open/floor/iron/white/corner,
/area/station/security/execution/transfer)
"E" = (
/obj/machinery/light_switch/directional/west{
	pixel_x = -24
	},
/obj/machinery/firealarm/directional/west{
	pixel_x = -36
	},
/obj/machinery/stasis{
	dir = 4
	},
/obj/machinery/iv_drip,
/obj/effect/turf_decal/tile/blue/anticorner{
	dir = 8
	},
/turf/open/floor/iron/white/corner{
	dir = 4
	},
/area/station/security/execution/transfer)
"H" = (
/obj/machinery/atmospherics/pipe/smart/manifold4w/supply/hidden/layer4,
/obj/machinery/atmospherics/pipe/smart/manifold4w/scrubbers/hidden/layer2,
/obj/effect/turf_decal/tile/blue/half,
/turf/open/floor/iron/white/side{
	dir = 1
	},
/area/station/security/execution/transfer)
"I" = (
/turf/closed/wall/r_wall,
/area/station/security/prison/safe)
"N" = (
/obj/item/radio/intercom/directional/north,
/obj/machinery/light/cold/directional/north,
/obj/effect/turf_decal/siding/dark_red,
/obj/structure/table/reinforced/rglass,
/obj/item/folder/white{
	pixel_x = -11;
	pixel_y = 2
	},
/obj/item/folder/blue{
	pixel_x = -6;
	pixel_y = 2
	},
/obj/item/paper_bin{
	pixel_x = 12;
	pixel_y = 7
	},
/obj/item/pen{
	pixel_x = 12;
	pixel_y = 8
	},
/turf/open/floor/iron/dark,
/area/station/security/execution/transfer)
"O" = (
/obj/effect/spawner/structure/window/reinforced,
/obj/structure/cable,
/obj/machinery/door/poddoor/preopen{
	id = "brigprison";
	name = "Prison Blast Door"
	},
/turf/open/floor/plating,
/area/station/security/execution/transfer)
"T" = (
/obj/structure/sign/departments/medbay/alt{
	pixel_x = -32
	},
/obj/structure/bed/medical,
/obj/item/clothing/suit/jacket/straight_jacket,
/obj/item/clothing/mask/muzzle,
/obj/item/clothing/glasses/blindfold,
/obj/effect/turf_decal/tile/blue/half{
	dir = 8
	},
/turf/open/floor/iron/white/side{
	dir = 4
	},
/area/station/security/execution/transfer)
"Z" = (
/obj/machinery/door/airlock/medical/glass{
	name = "Sanitarium"
	},
/obj/structure/cable,
/obj/machinery/atmospherics/pipe/smart/manifold4w/supply/hidden/layer4,
/obj/machinery/atmospherics/pipe/smart/manifold4w/scrubbers/hidden/layer2,
/obj/effect/mapping_helpers/airlock/access/all/security/brig,
/obj/effect/turf_decal/stripes/line{
	dir = 1
	},
/obj/effect/turf_decal/stripes/line,
/obj/machinery/door/firedoor,
/turf/open/floor/iron,
/area/station/security/execution/transfer)

(1,1,1) = {"
e
e
e
e
e
e
"}
(2,1,1) = {"
I
b
B
T
E
a
"}
(3,1,1) = {"
I
N
y
n
H
Z
"}
(4,1,1) = {"
I
m
s
c
j
a
"}
(5,1,1) = {"
e
e
O
e
e
e
"}
