//MAP CONVERTED BY dmm2tgm.py THIS HEADER COMMENT PREVENTS RECONVERSION, DO NOT REMOVE
"a" = (
/obj/effect/turf_decal/trimline/blue/filled/line{
	dir = 10
	},
/obj/structure/cable,
/obj/machinery/power/apc/auto_name/directional/west,
/obj/structure/table/reinforced/rglass,
/obj/item/reagent_containers/blood/o_minus{
	pixel_x = -4;
	pixel_y = 8
	},
/obj/item/reagent_containers/blood/o_minus{
	pixel_x = 0;
	pixel_y = 4
	},
/obj/item/reagent_containers/blood/lizard{
	pixel_x = 4;
	pixel_y = 0
	},
/obj/item/paper/fluff/jobs/medical/blood_types,
/turf/open/floor/iron/white,
/area/station/security/prison/safe)
"b" = (
/obj/machinery/camera/directional/west,
/obj/effect/turf_decal/trimline/blue/filled/line{
	dir = 9
	},
/obj/machinery/newscaster/directional/west,
/obj/machinery/atmospherics/components/unary/vent_pump/on/layer4{
	dir = 4
	},
/obj/structure/rack/shelf,
/obj/item/stack/medical/mesh,
/obj/item/stack/medical/suture,
/obj/item/stack/medical/wrap/sticky_tape/surgical,
/obj/item/stack/medical/wrap/gauze/twelve,
/turf/open/floor/iron/white,
/area/station/security/prison/safe)
"e" = (
/obj/machinery/door/airlock/medical/glass{
	id_tag = "MedbayFoyer";
	name = "Permabrig Medbay"
	},
/obj/structure/cable,
/obj/machinery/atmospherics/pipe/smart/manifold4w/supply/hidden/layer4,
/obj/machinery/atmospherics/pipe/smart/manifold4w/scrubbers/hidden/layer2,
/obj/machinery/door/firedoor,
/turf/open/floor/iron/white,
/area/station/security/prison/safe)
"h" = (
/obj/effect/turf_decal/trimline/blue/filled/line{
	dir = 6
	},
/obj/machinery/airalarm/directional/south,
/obj/structure/table/reinforced/rglass,
/obj/item/healthanalyzer/simple{
	pixel_x = 7;
	pixel_y = 5
	},
/obj/item/stack/medical/bruise_pack{
	pixel_x = -5;
	pixel_y = 8
	},
/obj/item/stack/medical/ointment{
	pixel_x = -3;
	pixel_y = -4
	},
/turf/open/floor/iron/white,
/area/station/security/prison/safe)
"j" = (
/obj/effect/turf_decal/trimline/blue/filled/line,
/obj/structure/cable,
/obj/machinery/iv_drip,
/turf/open/floor/iron/white,
/area/station/security/prison/safe)
"m" = (
/obj/structure/cable,
/obj/machinery/atmospherics/pipe/smart/manifold4w/scrubbers/hidden/layer2,
/turf/open/floor/iron/white,
/area/station/security/prison/safe)
"t" = (
/turf/closed/wall/r_wall,
/area/station/security/prison/safe)
"x" = (
/obj/effect/spawner/structure/window/hollow/reinforced/directional{
	dir = 1
	},
/obj/structure/cable,
/turf/open/floor/plating,
/area/station/security/prison/safe)
"z" = (
/obj/effect/turf_decal/trimline/blue/filled/line{
	dir = 5
	},
/obj/machinery/firealarm/directional/east,
/obj/structure/sink/directional/west,
/turf/open/floor/iron/white,
/area/station/security/prison/safe)
"B" = (
/obj/effect/turf_decal/trimline/blue/filled/line{
	dir = 8
	},
/obj/machinery/atmospherics/components/unary/vent_scrubber/on/layer2{
	dir = 4
	},
/obj/structure/cable,
/obj/structure/bed/medical/anchored,
/obj/item/bedsheet/medical{
	dir = 4
	},
/turf/open/floor/iron/white,
/area/station/security/prison/safe)
"M" = (
/obj/effect/turf_decal/trimline/blue/filled/line{
	dir = 4
	},
/obj/machinery/light/small/directional/east,
/obj/structure/bed/medical/anchored{
	dir = 4
	},
/obj/item/bedsheet/medical,
/obj/structure/sign/poster/official/cleanliness/directional/east,
/turf/open/floor/iron/white,
/area/station/security/prison/safe)
"O" = (
/turf/closed/wall,
/area/station/security/prison/safe)
"P" = (
/turf/closed/wall/r_wall,
/area/station/security/execution/transfer)
"S" = (
/obj/machinery/atmospherics/pipe/smart/manifold4w/supply/hidden/layer4,
/obj/effect/turf_decal/trimline/blue/filled/line{
	dir = 1
	},
/obj/structure/cable,
/obj/machinery/atmospherics/pipe/smart/manifold4w/scrubbers/hidden/layer2,
/turf/open/floor/iron/white,
/area/station/security/prison/safe)
"T" = (
/obj/effect/spawner/structure/window/reinforced,
/obj/structure/cable,
/turf/open/floor/plating,
/area/station/security/execution/transfer)
"V" = (
/obj/effect/spawner/structure/window/reinforced,
/obj/structure/cable,
/turf/open/floor/plating,
/area/station/security/prison/safe)

(1,1,1) = {"
P
P
T
P
P
"}
(2,1,1) = {"
V
b
B
a
t
"}
(3,1,1) = {"
e
S
m
j
x
"}
(4,1,1) = {"
V
z
M
h
t
"}
(5,1,1) = {"
O
O
O
O
t
"}
