//MAP CONVERTED BY dmm2tgm.py THIS HEADER COMMENT PREVENTS RECONVERSION, DO NOT REMOVE
"a" = (
/obj/effect/turf_decal/tile/blue/anticorner{
	dir = 1
	},
/obj/effect/turf_decal/siding/dark/inner_corner{
	dir = 1
	},
/turf/open/floor/iron/white/smooth_large,
/area/station/security/medical)
"d" = (
/obj/structure/window/reinforced/spawner/directional/north,
/obj/structure/table/reinforced,
/obj/machinery/computer/crew,
/obj/structure/cable,
/obj/effect/turf_decal/trimline/blue/filled/line{
	dir = 1
	},
/obj/effect/turf_decal/trimline/dark/line{
	dir = 1
	},
/obj/machinery/atmospherics/pipe/smart/manifold4w/supply/hidden/layer4,
/obj/machinery/atmospherics/pipe/smart/manifold4w/scrubbers/hidden/layer2,
/turf/open/floor/iron/white,
/area/station/security/medical)
"e" = (
/obj/machinery/door/window/right/directional/north{
	name = "Infirmary"
	},
/obj/machinery/duct,
/obj/effect/turf_decal/trimline/blue/filled/corner{
	dir = 1
	},
/obj/effect/turf_decal/trimline/blue/filled/corner{
	dir = 4
	},
/obj/effect/turf_decal/trimline/dark/corner{
	dir = 1
	},
/obj/effect/turf_decal/trimline/dark/corner{
	dir = 4
	},
/obj/machinery/atmospherics/pipe/smart/manifold4w/supply/hidden/layer4,
/turf/open/floor/iron/white,
/area/station/security/medical)
"f" = (
/obj/machinery/camera/directional/south{
	c_tag = "Security- Central"
	},
/obj/effect/turf_decal/tile/red/half,
/obj/machinery/firealarm/directional/south,
/turf/open/floor/iron/dark/side,
/area/station/security/brig)
"g" = (
/obj/machinery/duct,
/obj/effect/turf_decal/trimline/red/filled/warning,
/turf/open/floor/iron,
/area/station/security/brig)
"i" = (
/obj/structure/window/reinforced/spawner/directional/north,
/obj/machinery/airalarm/directional/west,
/obj/structure/table/reinforced,
/obj/effect/turf_decal/trimline/blue/filled/line{
	dir = 9
	},
/obj/effect/turf_decal/trimline/dark/line{
	dir = 9
	},
/obj/item/folder/red{
	pixel_x = 11;
	pixel_y = 2
	},
/obj/item/folder/white{
	pixel_x = 6;
	pixel_y = 2
	},
/obj/item/paper_bin{
	pixel_x = -7;
	pixel_y = 3
	},
/obj/item/pen{
	pixel_x = -8;
	pixel_y = 4
	},
/obj/item/reagent_containers/cup/glass/mug/nanotrasen{
	pixel_x = 9;
	pixel_y = -9
	},
/obj/item/storage/box/bodybags{
	pixel_y = -12;
	pixel_x = -6
	},
/turf/open/floor/iron/white,
/area/station/security/medical)
"k" = (
/obj/structure/cable,
/obj/effect/turf_decal/tile/blue,
/obj/machinery/atmospherics/pipe/smart/manifold4w/scrubbers/hidden/layer2,
/obj/structure/chair/office/light{
	dir = 8
	},
/obj/effect/landmark/start/security_medic,
/turf/open/floor/iron/white,
/area/station/security/medical)
"q" = (
/obj/effect/turf_decal/tile/blue/half{
	dir = 1
	},
/obj/effect/turf_decal/siding/dark{
	dir = 1
	},
/obj/effect/landmark/start/security_medic,
/turf/open/floor/iron/white/smooth_large,
/area/station/security/medical)
"r" = (
/obj/effect/turf_decal/trimline/blue/filled/corner,
/obj/effect/turf_decal/trimline/blue/filled/corner{
	dir = 8
	},
/obj/effect/turf_decal/tile/blue{
	dir = 1
	},
/obj/effect/turf_decal/trimline/dark/corner{
	dir = 8
	},
/obj/effect/turf_decal/trimline/dark/corner,
/obj/machinery/door/window/right/directional/south{
	pixel_x = 0;
	pixel_y = -4;
	opacity = 1;
	name = "Surgery"
	},
/turf/open/floor/iron/white,
/area/station/security/medical)
"u" = (
/obj/machinery/camera/directional/west{
	name = "Security - Medical"
	},
/obj/effect/turf_decal/trimline/blue/filled/line{
	dir = 10
	},
/obj/effect/turf_decal/trimline/dark/line{
	dir = 10
	},
/obj/machinery/light_switch/directional/west,
/obj/structure/table/reinforced,
/obj/item/reagent_containers/cup/bottle/multiver{
	pixel_x = 1;
	pixel_y = 19
	},
/obj/item/reagent_containers/cup/bottle/epinephrine{
	pixel_x = -7;
	pixel_y = 19
	},
/obj/item/reagent_containers/syringe{
	pixel_x = -4;
	pixel_y = 10
	},
/obj/item/reagent_containers/blood/lizard{
	pixel_x = 3;
	pixel_y = -1
	},
/obj/item/reagent_containers/blood/o_minus{
	pixel_x = -2;
	pixel_y = -1
	},
/obj/item/reagent_containers/blood/o_minus{
	pixel_x = -7;
	pixel_y = -1
	},
/obj/item/paper/fluff/jobs/medical/blood_types{
	pixel_x = 10;
	pixel_y = 1
	},
/obj/structure/window/reinforced/tinted/spawner/directional/south{
	pixel_x = 0;
	pixel_y = -4;
	opacity = 1
	},
/turf/open/floor/iron/white,
/area/station/security/medical)
"v" = (
/obj/structure/window/reinforced/spawner/directional/north,
/obj/structure/sink/directional/west,
/obj/effect/turf_decal/trimline/blue/filled/line{
	dir = 5
	},
/obj/effect/turf_decal/trimline/dark/line{
	dir = 5
	},
/obj/machinery/atmospherics/components/unary/vent_pump/on/layer4{
	dir = 8
	},
/obj/effect/landmark/start/security_medic,
/turf/open/floor/iron/white,
/area/station/security/medical)
"x" = (
/obj/machinery/atmospherics/pipe/smart/manifold4w/supply/hidden/layer4,
/obj/machinery/atmospherics/pipe/smart/manifold4w/scrubbers/hidden/layer2,
/obj/structure/cable,
/obj/machinery/duct,
/obj/effect/turf_decal/tile/red/half,
/turf/open/floor/iron/dark/side,
/area/station/security/brig)
"z" = (
/obj/machinery/power/apc/auto_name/directional/west,
/obj/structure/table/reinforced,
/obj/machinery/computer/records/medical/laptop{
	dir = 4;
	pixel_x = 4;
	pixel_y = 3
	},
/obj/structure/cable,
/obj/effect/turf_decal/trimline/blue/filled/line{
	dir = 8
	},
/obj/effect/turf_decal/trimline/dark/line{
	dir = 8
	},
/obj/machinery/light/cold/directional/west,
/turf/open/floor/iron/white,
/area/station/security/medical)
"C" = (
/turf/closed/wall,
/area/station/security/medical)
"F" = (
/obj/structure/sign/poster/official/cleanliness/directional/east,
/obj/machinery/stasis,
/obj/effect/turf_decal/trimline/blue/filled/line{
	dir = 4
	},
/obj/effect/turf_decal/trimline/dark/line{
	dir = 4
	},
/obj/item/bedsheet/medical,
/obj/machinery/iv_drip,
/turf/open/floor/iron/white,
/area/station/security/medical)
"I" = (
/obj/effect/turf_decal/tile/blue/anticorner,
/obj/effect/turf_decal/siding/dark/inner_corner,
/obj/structure/table/reinforced/rglass,
/obj/effect/spawner/surgery_tray/full,
/obj/machinery/vending/wallmed/directional/east,
/obj/structure/sign/clock/directional/south,
/turf/open/floor/iron/white/smooth_large,
/area/station/security/medical)
"J" = (
/obj/effect/turf_decal/tile/blue/anticorner{
	dir = 4
	},
/obj/effect/turf_decal/siding/dark/inner_corner{
	dir = 4
	},
/obj/structure/table/optable,
/obj/machinery/vitals_reader/directional/east,
/obj/item/clothing/gloves/latex{
	pixel_x = 0;
	pixel_y = 0
	},
/obj/item/clothing/mask/surgical{
	pixel_x = 0;
	pixel_y = -4
	},
/turf/open/floor/iron/white/smooth_large,
/area/station/security/medical)
"K" = (
/turf/closed/wall/r_wall,
/area/station/security/medical)
"L" = (
/obj/machinery/wall_healer/directional/east,
/obj/machinery/stasis,
/obj/effect/turf_decal/trimline/blue/filled/line{
	dir = 6
	},
/obj/effect/turf_decal/trimline/dark/line{
	dir = 6
	},
/obj/item/bedsheet/medical,
/obj/machinery/iv_drip,
/obj/structure/window/reinforced/tinted/spawner/directional/south{
	pixel_x = 0;
	pixel_y = -4;
	opacity = 1
	},
/turf/open/floor/iron/white,
/area/station/security/medical)
"M" = (
/obj/effect/turf_decal/tile/blue/anticorner/contrasted{
	dir = 8
	},
/turf/open/floor/iron/white,
/area/station/security/medical)
"N" = (
/obj/effect/turf_decal/tile/blue/anticorner{
	dir = 8
	},
/obj/effect/turf_decal/siding/dark/inner_corner{
	dir = 8
	},
/obj/structure/closet/secure_closet/personal/patient,
/obj/item/radio/intercom/directional/south,
/turf/open/floor/iron/white/smooth_large,
/area/station/security/medical)
"O" = (
/obj/effect/turf_decal/trimline/blue/filled/line,
/obj/effect/turf_decal/trimline/dark/line,
/obj/machinery/atmospherics/components/unary/vent_scrubber/on/layer2{
	dir = 1
	},
/obj/structure/closet/secure_closet/security_medic,
/obj/item/reagent_containers/spray/cleaner,
/obj/item/healthanalyzer,
/obj/structure/window/reinforced/tinted/spawner/directional/south{
	pixel_x = 0;
	pixel_y = -4;
	opacity = 1
	},
/turf/open/floor/iron/white,
/area/station/security/medical)
"Q" = (
/obj/machinery/light/cold/directional/south,
/obj/effect/turf_decal/tile/blue/half,
/obj/effect/turf_decal/siding/dark,
/obj/machinery/computer/operating{
	dir = 1
	},
/obj/machinery/status_display/evac/directional/south,
/turf/open/floor/iron/white/smooth_large,
/area/station/security/medical)
"T" = (
/obj/machinery/atmospherics/components/unary/vent_pump/on/layer4{
	dir = 1
	},
/obj/effect/turf_decal/tile/red/half,
/turf/open/floor/iron/dark/side,
/area/station/security/brig)
"U" = (
/obj/effect/turf_decal/tile/red/half,
/obj/machinery/duct,
/turf/open/floor/iron/dark/side,
/area/station/security/brig)
"X" = (
/obj/effect/turf_decal/trimline/red/real_red/end,
/obj/effect/turf_decal/siding/dark/end,
/obj/structure/bodycontainer/morgue{
	dir = 1
	},
/obj/effect/turf_decal/tile/neutral/half/contrasted{
	dir = 8
	},
/obj/structure/window/reinforced/tinted/spawner/directional/east{
	opacity = 1;
	pixel_x = 3;
	pixel_y = 0
	},
/turf/open/floor/iron/dark,
/area/station/security/medical)
"Z" = (
/obj/effect/turf_decal/trimline/red/real_red/end{
	dir = 1
	},
/obj/effect/turf_decal/siding/dark/end{
	dir = 1
	},
/obj/effect/turf_decal/tile/neutral/half/contrasted{
	dir = 8
	},
/obj/structure/sign/poster/official/moth_epi/directional/west,
/turf/open/floor/iron/dark,
/area/station/security/medical)

(1,1,1) = {"
U
K
K
K
K
K
K
"}
(2,1,1) = {"
U
i
z
u
Z
X
C
"}
(3,1,1) = {"
x
d
k
O
a
N
C
"}
(4,1,1) = {"
g
e
M
r
q
Q
C
"}
(5,1,1) = {"
T
v
F
L
J
I
C
"}
(6,1,1) = {"
f
C
C
C
C
C
C
"}
